Bug report — Документ, сообщающий о любом недостатке компонента или
системы, который может привести к тому, что компонент или система не сможет
выполнить свою требуемую функцию.

Заголовок
Defect ID — уникальный номер;
Summary — короткое описание бага; Название должно описывать проблему как можно
лучше. Помните, что заголовок читается чаще, чем любая другая часть отчета об ошибке.
Where? What? When?
Для кросс-браузерного – хорошо указывать конкретный браузер.
Project — название проекта;
Affected version — версия, в которой был найден баг;
Fix version — версия, в которой баг должен быть починен;
Reported By — человек, зарегистрировавший баг;Assign to — человек, который должен исправить баг;
Status — статус дефекта: открыт, в процессе, проверка, закрыт, переоткрыт;
Severity — атрибут, который показывает влияние дефекта на приложение;
Priority — атрибут, который показывает, как быстро должна быть исправлена ошибка.
Описание
Steps to reproduce (STR) – шаги, которые необходимо сделать, чтобы воспроизвести
ошибку.
Actual result — что происходит после воспроизведения;
Expected result — что ожидается, что должно происходить после воспроизведения. Как
должно работать.
Additional info
Preconditions - особые условия, которые необходимо выполнить перед основными
шагами воспроизведения ошибки;
Attachment — скриншоты, видео, файлы и т.д., которые помогают понять первопричину;
Labels — (?) для внутренней структуры и поиска
Component – помогает классифицировать баг (payment, account, registration)
Severity (важность) — он определяет влияние данного дефекта на систему.
Blocker, Critical, Major, Minor, Trivial
Priority (приоритет) — он определяет порядок, в котором мы должны устранить дефект.
High, Medium, Low
Высокий приоритет и низкая важность: ошибка в лого
Низкий приоритет и высокая важность: ошибка, где-то в десятой вкладке (например, при
нажатии справки, срабатывает ошибка 404)
